111111111111
11110C000011
1E0001110111
1C0001100C01
11P0X0001111
111111111111