11111111111111111111111
1C0000000000C0000000001
11111111111101111111111
11111111111101111111111
11111111110001111111111
1100000000010000000C001
1000000C0001000E0000001
10000C10000X00001100001
1000C00CC100000CCCCC0P1
11111111111111111111111