1111111111111111111111111111111111111
100C1C00000000C01C00000C00000000000C1
10001C1110C01111101111111100000000001
10111110100010000C100000C111111111001
1000C00C11011C0111101C00C0000X0001001
10111110010100010C101C11C00000000C001
101CCC1111011110E01011C11111111111001
100C00C0000000000000C1000000000000P01
1111111111111111111111111111111111111